1
100 100
81 14 3 94 35 31 28 17 94 13 86 94 69 11 75 54 4 3 11 27 29 64 77 3 71 25 91 83 89 69 53 28 57 75 35 0 97 20 89 54 43 35 19 27 97 43 13 11 48 12 45 44 77 33 5 93 58 68 15 48 10 70 37 80 79 46 73 24 90 8 5 84 29 98 37 10 29 12 48 35 58 81 46 20 47 45 26 85 34 89 87 82 9 77 81 21 68 93 31 20
59 48 34 81 88 71 28 87 41 98 99 7 29 4 40 51 34 8 27 72 91 40 27 83 63 50 82 58 18 33 17 31 95 71 68 33 95 74 54 74 51 46 28 17 65 63 11 96 6 14 19 80 20 87 54 76 8 49 48 76 59 67 32 70 1 87 92 14 87 68 96 34 98 82 43 14 37 55 20 58 0 92 92 33 64 97 22 64 13 80 38 81 64 77 25 19 47 97 20 69
99 67 0 76 41 62 2 14 46 39 30 7 30 72 10 10 93 62 8 97 68 98 16 16 84 60 70 21 33 67 77 54 27 69 96 93 88 25 91 39 51 85 83 47 56 66 57 15 31 28 8 43 2 75 70 29 75 28 0 9 90 80 7 29 8 4 42 9 65 30 35 85 62 27 69 16 92 73 73 60 31 100 60 52 24 12 12 84 55 45 54 52 59 93 6 86 83 82 12 7
51 93 43 13 31 24 24 68 57 17 54 23 35 59 31 9 56 70 12 6 83 69 1 11 96 30 21 52 62 61 27 51 7 21 48 0 49 33 100 100 58 36 54 89 93 100 71 84 91 62 19 24 37 27 7 74 94 69 7 95 40 7 6 74 61 64 67 20 7 65 10 23 8 76 8 86 30 51 15 72 31 74 76 5 79 10 53 84 74 72 66 40 33 26 85 91 40 30 33 50
16 85 82 38 58 40 96 9 1 58 79 72 12 9 68 27 64 33 16 44 8 31 47 36 20 56 69 90 38 78 83 67 1 85 70 38 84 13 17 33 14 13 95 70 19 34 36 77 26 91 43 26 87 81 33 64 62 32 6 11 81 54 35 5 0 42 98 16 81 33 20 94 56 70 90 54 71 1 14 9 88 19 69 4 47 74 70 18 55 16 5 39 46 5 45 26 87 31 85 13
45 99 71 52 79 95 19 30 20 22 52 3 22 94 42 100 52 85 94 31 34 20 100 89 13 48 4 60 28 25 58 44 39 29 28 3 84 24 51 42 35 8 98 35 44 82 65 51 86 68 42 3 14 33 22 74 33 4 13 76 55 44 93 100 40 55 77 65 14 49 73 24 32 5 90 55 0 66 68 87 92 94 94 85 25 46 55 8 85 42 79 40 84 15 92 38 64 39 85 52
41 51 89 37 70 16 24 53 85 48 86 95 22 78 72 38 51 70 0 38 36 26 55 100 74 77 83 41 59 56 56 86 27 65 60 94 21 84 10 36 65 84 81 79 42 11 96 30 86 39 28 25 18 3 5 31 60 78 98 9 58 53 80 73 24 91 89 49 63 51 31 18 83 88 0 96 98 13 99 54 28 22 89 66 59 6 71 31 15 58 17 59 85 67 71 76 40 96 56 78
92 64 54 70 57 20 95 60 57 33 96 31 81 35 98 99 66 62 80 30 35 56 9 91 36 30 34 42 40 69 10 17 19 29 49 88 19 90 27 8 53 52 42 69 59 53 7 26 53 49 98 74 89 2 97 73 48 61 0 45 38 96 49 53 68 95 94 69 77 28 62 28 34 55 62 3 49 43 85 86 51 92 21 59 16 79 68 3 50 75 72 84 3 10 82 54 17 59 23 6
33 48 41 27 58 41 43 97 48 35 96 53 32 10 60 2 95 69 6 44 28 83 8 99 83 5 96 3 31 25 2 79 19 30 16 60 85 14 72 27 59 89 32 98 47 21 77 77 95 91 14 99 20 39 13 74 3 39 73 86 48 50 91 25 9 75 88 80 31 13 89 98 38 87 76 15 72 100 5 44 68 54 84 47 8 64 82 43 1 53 62 13 55 46 81 58 90 19 55 22
93 66 83 34 78 68 99 61 59 55 93 75 34 41 31 11 35 57 31 96 59 72 78 85 48 43 3 63 41 23 62 27 45 33 43 35 76 89 35 71 1 66 24 10 30 92 52 62 71 97 30 88 60 82 91 62 57 2 11 37 28 51 88 31 39 84 74 47 60 70 67 44 54 95 70 42 45 89 58 34 39 32 29 15 92 24 40 15 95 68 97 88 23 24 27 94 61 35 92 75
97 67 76 36 12 24 37 29 46 22 38 1 90 68 16 35 5 6 70 37 89 16 81 96 62 13 1 73 36 60 61 56 43 23 6 32 61 14 8 51 62 9 73 80 87 6 19 19 72 38 10 31 15 71 97 53 77 76 79 28 99 66 48 57 56 38 75 54 39 72 79 7 78 94 12 97 26 80 27 33 84 10 20 30 22 70 9 20 0 52 57 88 76 60 37 4 29 36 90 36
89 58 9 87 29 33 100 80 75 84 25 54 14 69 28 82 19 34 18 9 7 21 39 76 95 72 36 56 15 59 88 38 89 51 34 64 69 63 56 10 76 5 55 94 41 77 32 3 11 29 86 73 75 2 97 86 34 73 5 97 96 22 60 66 83 56 35 23 74 55 81 62 11 60 44 52 42 41 85 13 20 42 52 88 63 36 84 51 97 70 4 58 11 40 32 41 14 98 51 65
0 84 69 59 52 6 24 66 46 79 96 63 80 56 97 6 26 34 70 16 36 56 89 62 15 3 80 77 30 90 20 39 70 1 70 52 11 28 14 59 15 82 19 63 91 37 65 90 34 53 61 60 31 58 70 18 49 24 76 65 95 17 8 35 98 53 43 100 64 34 0 36 92 38 75 74 84 62 19 57 68 61 44 42 70 97 69 48 58 41 24 89 30 73 49 29 99 52 5 40
95 60 90 48 49 84 83 19 63 4 16 64 75 42 12 56 12 67 58 1 92 18 52 83 19 9 60 100 33 43 79 88 50 83 10 42 86 68 48 40 80 91 97 62 69 4 79 8 30 80 87 36 29 95 11 55 12 97 81 90 12 56 21 88 38 3 5 41 7 37 45 47 55 18 31 67 52 72 87 23 21 22 10 78 48 79 87 30 63 74 18 29 59 81 32 58 32 85 1 59
36 86 69 20 9 56 44 75 38 81 54 88 32 58 38 25 49 61 13 30 48 73 45 73 37 89 37 2 84 50 35 1 72 87 99 95 6 77 95 63 36 99 29 77 45 28 81 24 79 32 86 96 92 98 84 87 17 80 12 80 82 5 39 100 56 4 74 46 93 16 11 37 41 95 53 22 25 16 100 69 46 67 64 34 21 32 61 37 95 43 14 59 9 18 96 28 86 92 86 50
71 46 11 50 1 33 68 15 58 47 86 95 86 33 74 48 81 47 13 86 29 60 3 79 71 41 78 28 82 8 81 59 89 38 83 52 14 17 5 4 38 63 14 12 30 68 17 49 58 47 85 95 89 69 53 75 95 93 19 53 83 12 62 78 52 35 4 88 47 27 56 56 30 46 12 87 47 69 82 45 7 50 35 24 15 58 11 84 27 82 81 76 2 6 100 42 31 16 100 72
26 8 97 70 26 75 27 29 42 99 18 100 76 0 35 18 16 69 32 22 14 84 3 16 1 45 100 30 75 41 2 22 33 6 16 94 53 67 14 95 8 60 57 99 46 65 75 13 57 64 28 78 5 93 100 84 66 38 58 82 3 7 61 51 54 87 13 62 91 56 9 10 41 77 18 8 16 35 79 81 74 70 91 41 48 76 67 37 58 64 77 55 12 89 14 83 83 98 70 92
27 55 57 29 52 43 58 51 53 93 12 40 54 40 85 32 47 19 87 60 8 11 10 11 55 12 95 94 47 16 71 7 75 71 71 42 85 15 52 45 85 96 54 92 6 36 76 39 45 13 73 64 27 19 84 61 28 13 44 71 47 14 97 35 73 28 54 71 98 79 78 86 82 71 3 77 84 88 34 3 23 34 89 97 39 43 44 0 23 18 72 84 51 8 18 94 81 3 11 95
67 27 48 53 58 43 20 47 39 92 41 99 72 76 10 6 19 20 96 79 6 86 10 34 56 84 54 62 77 56 53 34 27 96 65 14 44 55 14 36 86 86 75 62 67 85 39 5 28 50 76 7 0 26 38 27 98 17 97 32 37 41 15 0 63 95 55 22 16 48 68 90 29 64 71 85 45 9 50 94 5 55 2 58 9 40 73 54 73 51 90 81 53 37 14 51 2 41 21 79
58 88 46 11 55 13 31 55 75 51 67 10 50 39 95 43 28 42 99 21 9 65 81 14 67 65 24 99 44 44 93 82 18 30 13 18 32 25 22 77 19 97 97 83 9 22 98 80 63 59 96 72 97 74 57 87 72 82 81 79 41 80 40 19 56 8 60 56 80 38 35 75 7 45 64 9 39 59 57 4 7 47 36 9 82 11 78 76 64 49 59 74 70 94 5 57 73 83 24 41
77 60 64 19 7 57 13 43 91 10 64 82 22 5 31 90 56 56 67 66 78 20 46 47 36 49 52 99 43 86 76 6 80 82 42 8 42 12 71 86 49 36 32 92 84 77 19 42 10 74 84 18 44 39 83 89 84 50 16 76 90 10 39 71 48 82 42 16 85 89 94 87 67 11 82 85 54 65 46 2 46 39 23 27 43 98 62 24 28 17 19 9 37 100 12 64 98 69 94 67
4 84 43 98 79 16 76 48 19 20 23 88 98 79 21 92 56 5 52 46 86 92 30 56 78 36 96 95 100 57 29 68 30 39 100 60 24 47 86 73 56 59 98 36 99 48 64 67 53 20 25 77 17 32 6 82 61 47 70 13 91 66 15 36 10 97 20 34 57 65 18 55 11 28 57 44 3 53 6 50 64 47 30 49 10 47 28 3 40 12 91 83 42 18 17 4 36 60 89 17
97 90 60 57 78 0 10 2 32 27 19 70 93 77 67 54 14 99 36 30 38 15 6 30 53 81 79 58 8 14 63 76 68 2 80 65 73 30 91 18 37 54 0 78 45 30 73 53 23 85 85 10 67 46 8 67 69 64 100 64 70 2 49 60 5 81 49 47 32 95 2 45 100 8 44 30 93 84 80 13 98 74 94 96 42 17 5 45 69 43 82 22 99 87 59 89 61 80 23 17
8 91 99 58 4 37 25 5 25 5 40 39 65 50 69 60 32 4 96 82 24 36 45 99 6 83 42 34 15 47 55 51 95 56 49 43 23 63 88 63 47 66 34 10 93 54 10 55 77 23 69 37 41 13 10 41 84 37 39 57 77 91 54 21 88 56 44 57 5 93 45 78 55 35 81 7 9 85 81 51 46 65 95 86 20 3 18 77 86 100 56 4 16 8 30 99 82 46 46 49
72 4 77 19 86 57 47 47 56 97 9 73 17 67 46 50 40 83 35 31 14 3 94 23 63 66 49 71 15 33 99 33 90 57 27 78 36 88 62 25 15 17 9 57 22 91 56 11 87 40 85 44 90 8 70 69 37 38 20 91 90 89 81 22 46 65 28 15 25 17 30 63 3 46 70 73 47 59 70 16 78 11 8 39 50 91 92 61 67 52 98 52 73 9 16 40 82 9 57 59
87 66 44 16 99 70 81 75 23 98 16 55 64 7 15 66 19 38 21 20 41 90 28 44 66 36 10 32 25 81 70 35 16 80 38 78 68 11 64 82 21 75 74 19 21 84 79 92 77 43 72 5 3 10 5 82 98 73 33 83 26 98 73 53 79 81 3 63 80 69 37 82 38 61 31 87 51 38 58 9 88 7 20 56 53 61 59 26 43 77 18 40 91 40 93 44 51 16 97 47
65 71 13 40 30 59 15 34 57 31 18 12 6 37 49 78 53 31 20 41 73 92 40 24 97 20 63 65 59 63 39 63 2 11 50 64 58 30 27 74 45 6 6 36 63 76 83 86 60 36 68 1 13 55 17 33 93 46 97 51 46 5 51 6 72 71 24 46 70 36 9 49 64 57 97 70 35 79 87 78 15 16 12 50 47 43 71 46 96 18 25 77 65 51 64 5 5 4 17 91
42 60 66 58 19 77 65 17 41 78 40 20 50 78 94 38 75 43 64 65 68 62 90 72 38 60 2 47 42 86 14 53 74 39 92 88 80 3 76 60 33 83 100 99 74 73 29 92 6 74 61 21 67 80 92 79 99 48 18 87 31 4 73 89 14 24 2 56 40 53 19 52 88 26 52 64 99 78 60 94 93 7 90 17 66 26 71 41 84 61 67 48 40 22 58 68 43 69 45 86
98 92 87 82 88 33 78 61 24 31 35 71 38 28 38 98 36 90 26 88 90 62 40 61 44 71 92 35 36 15 73 86 69 48 50 44 98 18 37 5 36 91 10 44 56 83 32 95 61 27 25 68 34 71 89 34 17 13 78 94 75 30 31 6 85 67 28 81 29 6 12 52 42 91 60 12 87 98 17 0 70 20 52 83 60 61 83 25 96 36 41 36 82 7 98 11 83 73 29 68
94 92 4 22 53 22 4 50 100 63 23 95 37 4 1 38 72 77 13 42 36 58 82 69 67 63 17 64 59 34 24 14 42 20 93 58 82 32 91 23 1 94 43 37 72 86 96 24 22 78 81 51 54 65 41 11 51 85 12 23 17 61 41 31 0 33 49 30 57 96 34 42 38 74 92 73 1 33 83 46 88 30 7 85 15 59 39 20 51 87 64 90 98 39 88 15 81 37 47 78
28 28 17 61 19 58 95 77 47 53 89 70 60 96 68 85 27 97 31 87 96 76 100 10 67 57 67 90 46 9 72 14 7 70 64 25 73 68 19 21 41 66 56 14 87 26 91 74 62 11 65 57 7 58 16 65 53 58 72 7 71 59 86 39 92 2 50 32 0 95 27 74 9 5 54 44 89 8 69 7 8 60 4 36 52 23 98 17 98 82 93 82 53 47 48 57 48 48 10 87
84 69 17 83 44 15 22 68 50 67 16 93 28 0 96 2 38 59 86 92 69 54 68 48 29 31 58 44 19 35 24 92 97 14 4 84 53 78 98 2 30 26 8 12 76 4 57 76 86 90 6 31 94 5 51 56 29 69 27 96 99 7 17 64 37 29 93 73 40 73 76 98 86 41 30 38 18 84 66 28 52 38 35 7 71 75 94 22 80 86 54 71 63 6 44 82 85 48 100 67
40 89 53 52 19 38 48 23 96 68 60 30 28 38 90 18 59 7 71 52 53 71 67 17 49 31 32 26 42 82 10 57 47 11 68 92 24 6 34 48 86 77 77 5 9 24 97 75 92 85 71 27 61 26 42 38 1 27 24 94 15 95 96 61 31 89 77 90 26 50 30 70 41 99 36 48 59 68 83 45 39 33 46 65 63 59 12 92 60 97 40 26 47 40 52 5 72 28 94 18
2 33 70 74 74 92 53 37 19 25 42 29 48 72 31 63 70 83 87 43 32 97 62 92 82 94 62 58 21 93 45 21 17 92 69 62 23 69 82 7 67 4 9 85 6 97 0 52 17 80 29 8 90 19 1 27 64 58 47 7 79 81 85 78 61 84 62 2 0 68 70 52 1 2 67 92 35 68 36 2 64 89 86 55 22 13 12 67 19 30 24 79 67 32 45 34 50 10 47 51
58 72 31 89 28 38 87 10 83 83 97 4 11 51 48 48 70 60 7 81 1 89 21 10 63 55 82 100 42 72 12 67 5 29 27 88 72 60 34 5 9 87 35 69 72 84 4 22 40 2 26 75 18 96 91 50 9 38 20 72 30 72 49 86 69 42 49 96 94 17 88 92 10 64 95 44 6 12 55 29 9 43 77 98 78 76 50 99 41 3 81 34 100 57 62 29 45 70 48 55
23 87 74 84 48 10 98 79 37 31 91 9 10 34 19 48 91 100 81 19 94 49 40 46 13 11 0 39 56 46 97 34 13 16 11 23 55 57 71 71 65 52 13 3 11 45 70 11 76 76 100 41 49 1 37 52 49 99 10 92 71 31 73 66 21 87 48 21 17 34 38 34 63 18 8 21 55 35 53 38 61 100 9 46 32 31 92 80 63 76 78 25 58 13 17 38 0 50 42 79
48 42 56 42 55 83 76 17 38 41 77 88 25 61 40 22 50 40 37 94 88 81 62 73 100 31 41 48 35 100 50 46 14 72 25 75 69 23 87 98 70 3 93 59 90 26 56 37 88 8 52 86 63 17 81 38 30 32 84 19 91 54 48 9 57 76 61 74 51 68 64 88 53 69 4 46 89 68 76 81 10 13 98 31 84 85 45 21 82 78 5 72 82 86 82 51 96 42 55 13
1 12 33 28 65 95 66 71 74 88 73 28 57 47 50 59 98 86 75 88 64 19 44 3 61 13 37 53 10 14 93 18 44 39 43 58 100 26 66 61 44 60 12 56 92 89 57 40 8 38 5 90 14 2 43 82 13 86 21 94 31 66 22 70 20 42 71 54 59 29 51 80 23 23 81 84 55 50 3 94 78 25 57 75 54 49 0 90 27 26 35 96 90 8 73 13 68 23 46 41
25 58 14 33 85 62 67 81 40 76 49 78 50 75 14 44 45 58 79 22 86 90 38 78 75 10 86 17 40 15 30 39 14 23 47 88 18 65 49 53 76 17 73 49 54 23 62 81 68 88 82 22 71 21 62 36 17 23 40 57 79 6 45 1 62 17 24 49 71 64 83 63 52 87 62 53 90 56 62 21 10 72 3 97 28 37 4 35 28 68 36 21 99 58 72 95 98 98 63 70
65 14 73 14 34 99 69 46 69 96 5 97 92 56 69 27 54 13 94 83 96 31 38 4 57 33 44 11 56 15 99 30 26 94 75 88 44 90 78 80 54 21 78 17 100 26 26 7 72 44 68 35 76 68 21 41 90 37 37 73 34 65 86 12 17 96 100 52 7 35 83 16 89 16 31 18 91 41 31 97 86 50 62 18 73 80 34 80 53 48 57 9 81 98 11 51 65 95 35 88
47 58 62 41 74 0 99 93 11 93 58 81 85 89 45 8 68 50 27 54 27 63 34 41 36 43 70 73 16 72 62 100 43 87 97 6 5 12 80 100 58 2 15 20 56 58 0 54 25 88 16 83 38 20 35 11 83 46 32 10 47 85 83 21 6 50 80 39 92 89 96 29 54 83 11 90 12 0 27 61 9 16 75 28 66 87 56 1 1 89 43 15 54 88 16 61 9 29 49 11
93 13 13 40 47 38 17 48 99 96 17 82 86 18 8 67 72 1 78 83 21 56 44 92 27 80 95 19 52 78 87 56 27 11 12 17 96 15 75 93 49 44 54 40 17 31 35 82 10 31 70 76 76 92 77 36 99 88 3 84 38 26 66 77 65 24 95 50 37 82 6 100 30 63 49 14 30 63 81 76 9 67 1 46 40 16 49 72 53 46 69 87 22 97 60 98 9 2 75 8
1 33 27 5 7 50 64 36 80 91 64 98 53 54 89 51 10 81 68 68 78 19 35 10 39 10 65 26 19 68 41 50 75 81 97 83 87 82 8 39 89 55 93 30 7 31 11 55 14 58 78 77 7 39 85 94 84 94 22 15 1 90 17 89 1 20 63 44 66 66 100 92 33 21 47 16 95 99 34 93 15 98 3 42 54 34 67 8 33 91 73 80 9 63 58 65 46 7 63 72
21 47 20 32 98 13 73 86 92 14 29 94 65 0 5 1 31 5 60 46 49 19 22 4 70 91 94 83 53 28 41 31 53 92 40 34 9 73 47 15 64 86 6 22 28 66 5 51 8 59 36 99 39 41 11 70 58 1 47 25 37 72 100 38 94 79 31 59 47 75 63 98 99 25 93 69 97 31 19 0 52 3 29 69 44 81 88 1 42 0 97 84 48 94 93 39 13 26 67 30
53 62 7 18 91 35 11 5 29 66 52 89 47 58 95 10 74 12 64 17 81 50 9 75 72 7 55 84 16 30 37 33 40 50 89 94 41 40 57 34 29 9 25 17 99 98 74 13 19 13 21 57 59 40 52 15 68 45 98 26 57 39 59 33 15 11 20 87 38 90 89 77 5 27 41 18 11 91 31 45 50 65 6 86 38 33 22 3 51 57 71 95 70 31 12 59 13 17 15 1
7 99 28 16 25 51 47 87 80 82 10 74 75 33 9 2 8 25 82 56 16 11 42 15 5 59 6 21 73 55 92 50 63 3 48 87 54 22 45 27 23 35 35 57 19 4 78 79 78 31 82 37 63 52 70 61 7 11 35 49 17 53 25 82 67 31 80 69 2 48 100 91 45 61 69 100 62 44 72 64 41 49 34 23 3 40 76 28 3 99 35 7 60 67 45 98 74 29 20 12
31 84 30 34 68 94 7 97 28 73 49 45 22 22 30 75 40 94 89 45 75 3 90 89 45 72 72 18 72 24 63 69 39 22 62 4 11 7 29 77 28 2 67 61 0 42 78 25 16 43 91 22 41 7 2 18 75 90 18 99 14 67 46 9 47 90 84 50 75 12 43 38 41 17 20 93 55 81 62 83 40 22 90 71 88 78 100 45 28 85 75 22 48 39 93 88 37 16 22 93
0 89 73 50 98 72 4 23 77 40 78 28 81 72 13 63 18 42 95 9 30 44 40 21 81 11 90 85 81 93 42 57 1 33 26 31 88 8 44 32 100 13 92 0 6 49 56 93 53 21 52 63 48 44 69 48 12 61 100 73 83 97 87 28 20 57 9 4 37 2 40 33 13 9 43 21 48 20 93 9 70 11 43 76 78 61 90 3 55 83 21 77 55 20 6 12 42 26 24 52
89 70 92 93 69 33 84 36 38 30 12 6 50 73 70 62 19 6 46 0 54 11 37 84 80 76 61 25 12 3 26 21 81 37 10 60 14 39 100 50 60 62 84 33 11 82 69 49 23 47 48 47 23 57 5 33 56 59 33 28 34 72 7 19 96 89 85 12 10 85 44 69 52 96 75 29 70 7 49 66 53 68 87 60 73 30 60 38 10 50 91 4 64 73 66 73 86 79 18 15
96 57 22 21 27 24 16 5 54 10 87 55 25 80 18 76 33 40 93 8 11 49 71 50 70 41 35 66 58 1 100 89 79 75 66 100 53 14 53 19 18 72 75 74 97 12 13 72 99 12 100 36 68 44 52 33 49 83 62 73 77 60 4 22 35 51 18 79 77 87 88 51 4 50 42 88 30 6 95 60 34 47 2 43 38 39 35 62 89 87 12 29 17 38 95 56 99 41 34 93
53 77 82 11 24 56 27 52 94 62 97 66 47 7 65 20 8 39 90 64 51 17 99 67 72 3 22 24 25 7 31 4 58 6 46 90 25 35 47 59 64 50 81 15 87 3 30 47 62 76 57 22 60 75 70 44 44 20 33 95 88 11 36 3 49 6 20 73 99 27 28 82 28 86 26 34 83 52 65 2 99 98 87 1 60 16 82 22 76 1 28 32 77 39 91 90 82 35 54 48
44 58 32 27 59 38 86 66 79 50 74 13 0 65 84 47 71 82 76 77 36 38 87 13 61 8 43 35 81 41 35 33 83 91 83 38 24 19 66 97 30 7 76 51 84 40 87 17 92 3 83 63 37 33 53 51 49 94 4 74 90 73 24 43 92 91 28 87 68 81 100 60 85 45 64 38 21 84 71 23 37 12 60 16 94 33 92 71 97 23 87 42 83 11 28 45 28 95 39 53
100 42 47 33 74 37 59 15 60 6 81 74 74 79 9 60 24 64 15 87 48 67 38 52 6 19 17 25 43 52 72 58 18 40 91 23 99 10 62 42 80 22 40 81 7 0 57 35 26 97 99 21 73 97 20 62 100 97 99 11 16 78 55 81 54 51 54 61 49 0 4 68 25 93 47 1 41 96 67 24 2 86 0 80 93 31 28 88 44 39 16 13 49 64 75 39 21 8 5 38
37 58 93 66 76 67 43 55 87 17 43 62 45 96 24 21 51 2 29 28 93 16 27 93 2 75 64 21 15 46 91 83 4 48 81 32 98 68 79 6 76 6 84 13 83 2 6 88 14 53 56 48 15 70 32 60 89 19 26 88 87 80 1 38 53 84 12 84 66 34 79 77 89 17 53 13 65 92 79 15 36 14 100 13 63 25 77 25 99 33 66 25 45 90 52 37 20 5 70 63
26 88 61 42 30 0 1 85 11 14 73 85 63 19 11 99 65 9 92 92 12 32 82 29 58 37 33 59 6 12 22 5 37 46 86 40 54 94 14 12 97 5 1 17 84 82 21 42 45 56 79 34 93 11 47 43 23 14 51 51 58 34 49 88 61 53 83 21 14 16 89 92 7 20 13 53 75 61 72 86 56 23 78 48 99 45 78 3 87 93 16 61 62 14 52 56 5 8 33 83
40 1 90 86 67 98 95 73 92 72 28 85 43 66 66 88 89 79 12 55 84 93 31 61 44 84 86 82 49 19 71 78 6 1 82 20 64 60 63 21 9 96 62 41 30 42 35 6 64 28 70 82 48 51 30 10 58 56 73 57 11 63 57 40 15 63 95 83 2 13 51 52 4 71 70 0 11 77 79 81 38 65 71 26 83 85 58 43 46 6 28 58 42 71 98 79 76 60 91 84
46 91 57 14 12 97 84 28 0 43 45 81 37 70 66 47 89 13 5 21 63 17 91 95 92 52 13 32 78 25 24 15 50 27 58 100 24 91 43 13 96 53 5 81 86 75 15 98 57 58 84 75 64 17 63 0 67 94 6 70 55 74 61 65 99 22 88 74 22 93 16 13 49 84 76 77 41 64 49 53 77 88 97 31 35 50 43 37 57 17 17 52 77 89 95 65 38 89 70 40
91 94 70 80 27 25 26 79 91 37 87 44 86 16 90 83 22 64 69 88 81 41 90 14 97 45 71 61 74 73 85 90 53 86 95 68 36 54 1 66 13 3 48 18 6 85 7 25 34 96 100 20 36 87 32 18 7 88 100 37 26 96 69 4 45 57 13 78 86 94 71 28 95 82 71 49 30 65 100 89 36 88 85 6 48 49 53 100 87 40 70 6 1 95 32 25 79 99 56 28
81 90 90 82 47 96 75 69 94 77 25 99 92 24 37 57 22 87 9 23 22 94 65 15 48 5 54 35 71 33 16 20 74 32 0 42 59 90 19 5 19 41 76 6 99 80 78 84 38 62 73 70 45 9 100 90 40 67 28 23 66 8 100 64 20 53 69 68 51 11 44 28 27 84 42 42 46 37 27 96 79 67 60 71 96 83 1 14 85 44 57 30 82 78 79 31 5 87 41 48
14 49 32 69 92 36 3 66 98 47 65 65 57 62 5 37 83 24 41 65 10 12 21 98 68 68 0 80 8 26 85 80 99 27 87 54 13 26 68 89 94 99 55 82 9 95 87 19 3 58 91 42 4 11 9 6 22 32 71 9 73 29 33 52 49 57 80 51 55 40 2 49 86 15 68 0 82 92 79 8 96 95 74 5 89 9 45 64 13 37 100 87 38 77 11 36 97 56 48 50
84 3 60 20 68 28 17 95 50 69 37 81 18 38 86 93 82 47 1 70 71 18 15 5 0 73 76 50 68 70 10 39 26 95 94 92 44 27 52 82 65 18 20 23 28 78 32 24 14 23 85 72 6 96 70 59 82 70 9 37 85 8 32 12 25 92 74 62 42 45 16 85 83 30 12 36 79 8 24 40 62 57 42 78 84 39 88 74 19 72 72 46 40 54 21 0 40 31 100 28
91 94 82 55 35 46 17 86 93 42 61 59 57 45 99 39 62 70 13 22 82 77 10 35 17 68 25 33 93 80 9 93 9 2 64 80 3 74 74 51 98 75 27 4 70 33 69 69 60 83 99 19 46 50 28 98 75 93 37 17 59 64 65 11 50 46 64 1 84 30 78 87 21 96 65 17 57 20 22 72 72 84 18 94 93 61 45 5 28 97 62 29 8 33 47 29 5 85 26 66
46 49 60 58 5 5 83 41 13 90 66 81 35 94 33 74 69 72 22 48 83 48 46 75 83 9 66 32 48 28 66 51 45 44 62 61 77 0 64 17 56 21 29 9 65 82 35 27 19 23 20 46 77 91 15 84 29 53 42 92 14 61 86 61 61 26 75 20 82 52 2 31 5 16 73 75 20 17 80 65 5 73 18 7 21 33 23 66 51 76 72 81 2 92 93 84 36 10 27 57
77 60 61 21 28 52 76 18 74 98 23 79 84 65 33 21 92 87 43 58 76 75 8 29 48 49 16 13 2 25 66 64 87 53 19 77 12 22 60 78 76 4 100 68 64 96 15 11 61 84 16 77 69 0 99 86 83 55 66 53 47 5 89 67 54 29 61 98 48 44 75 94 97 89 73 12 54 17 32 61 98 29 10 36 76 69 52 32 24 0 90 95 0 73 66 15 66 0 48 83
26 88 40 52 46 13 19 54 83 74 32 33 68 54 72 46 78 35 87 50 96 26 52 70 100 71 61 22 47 71 71 61 32 39 73 44 99 90 50 94 17 84 15 95 29 57 100 89 20 12 27 65 51 100 43 70 78 89 87 90 6 20 49 81 0 11 18 60 76 55 11 8 33 28 47 10 77 4 92 49 51 78 83 66 36 91 76 7 99 22 81 63 56 1 25 84 66 36 24 4
100 76 65 66 89 29 78 21 86 4 46 30 83 0 20 11 35 99 51 45 85 50 51 75 25 66 1 94 90 8 11 70 36 92 71 74 44 44 35 28 77 24 58 51 73 0 33 22 52 64 13 71 9 64 37 43 14 65 32 68 73 32 88 56 48 72 61 98 31 96 43 99 58 87 58 75 3 61 14 33 8 48 81 100 28 86 89 29 40 52 45 66 68 1 89 33 31 36 11 51
86 95 43 9 70 22 60 40 45 27 73 34 23 95 87 24 63 94 25 30 94 30 33 26 29 25 31 79 45 19 99 13 15 10 86 84 63 78 0 97 69 5 61 47 79 40 63 73 35 62 23 97 65 35 50 28 96 73 16 6 67 54 61 69 4 64 44 50 87 99 22 58 15 89 66 58 40 88 1 1 86 26 48 74 12 41 46 78 33 23 70 33 30 34 60 78 43 46 23 63
54 26 53 89 96 47 46 51 35 57 23 73 16 73 87 29 12 92 34 30 71 55 48 25 18 94 19 60 1 22 53 63 17 80 66 68 92 40 100 62 38 32 71 72 6 50 12 88 20 7 27 32 60 80 12 57 95 42 33 46 46 71 71 32 44 2 52 15 44 86 77 25 73 73 83 83 68 22 99 36 45 41 86 65 62 99 94 57 10 48 78 36 59 80 18 21 81 43 53 80
78 73 51 9 10 20 43 29 40 40 83 37 90 34 77 82 50 34 56 99 46 95 75 66 57 52 21 23 2 16 93 30 84 32 95 89 95 10 26 21 50 13 12 8 60 70 6 3 98 50 67 97 10 13 33 79 19 10 83 49 39 29 31 94 36 56 80 16 16 67 21 3 4 84 45 41 60 59 69 34 70 56 17 89 69 22 75 76 58 80 95 81 72 55 67 81 81 68 39 44
61 69 29 11 56 39 46 52 33 19 38 1 0 66 97 17 44 36 60 68 1 88 62 96 61 38 1 98 55 37 76 29 0 70 47 24 52 71 55 50 31 20 91 94 82 49 48 28 33 10 54 80 30 66 97 78 88 87 34 36 83 95 68 34 52 24 8 23 17 37 14 81 58 79 57 34 89 79 62 24 41 2 19 6 68 2 23 13 36 34 16 91 56 93 1 29 11 19 1 63
27 43 53 39 100 63 47 59 89 4 42 10 96 18 7 34 99 50 9 69 60 23 24 32 48 1 15 98 91 31 49 98 56 31 94 4 25 58 94 98 12 66 85 26 60 49 87 39 41 20 80 93 5 95 70 66 15 32 61 81 38 25 46 6 85 27 14 30 81 55 41 1 21 35 74 15 50 31 1 5 74 100 88 60 88 76 19 47 98 11 31 20 63 11 87 79 43 97 80 7
7 45 82 19 89 68 13 16 62 29 40 71 100 82 96 44 56 93 24 2 88 48 45 92 17 32 5 62 90 56 71 37 69 89 62 24 72 23 69 44 41 93 59 35 76 70 20 8 67 19 57 37 33 69 46 58 0 99 81 64 48 93 23 2 79 46 99 79 30 41 92 8 84 68 49 24 67 87 63 98 70 19 78 36 41 52 82 41 14 12 66 84 8 5 16 22 4 25 13 62
24 12 4 73 82 49 84 62 67 79 89 75 32 6 46 28 77 91 9 1 26 83 62 10 59 81 7 46 71 95 53 47 90 7 78 34 67 5 93 9 38 9 27 66 12 12 92 29 68 49 24 24 67 84 31 72 80 22 71 95 71 53 95 13 98 81 73 45 86 58 89 85 54 13 21 23 70 51 64 43 84 20 68 76 56 45 40 70 41 47 52 97 81 55 92 41 77 30 72 69
27 48 98 70 95 32 46 57 57 50 0 92 4 36 76 2 66 17 38 0 38 28 27 40 2 98 88 35 70 65 71 73 73 19 12 4 58 45 19 17 33 46 74 31 29 32 38 11 73 51 72 27 93 9 92 41 61 22 62 88 89 73 12 76 82 38 4 93 73 48 10 99 7 98 42 44 55 53 15 98 29 95 83 77 1 81 99 80 48 6 39 67 5 40 69 72 19 41 64 89
28 19 6 86 93 50 57 96 76 73 64 11 28 55 37 100 50 18 16 43 10 60 73 95 6 70 51 33 10 51 64 55 99 89 16 97 17 61 71 25 62 50 83 73 25 71 78 94 67 31 31 9 34 99 55 41 87 73 11 14 85 52 54 46 44 24 41 44 76 83 3 98 39 21 44 78 56 79 18 56 5 29 25 87 47 19 96 93 10 14 94 6 31 79 18 36 1 43 88 14
39 57 60 2 42 26 94 68 27 26 69 66 96 33 70 61 79 93 18 88 89 85 2 48 74 84 67 5 32 21 7 36 25 89 79 34 6 59 83 1 8 49 84 34 84 84 46 13 2 37 83 49 29 48 65 90 12 40 62 76 68 11 23 25 64 58 71 91 2 5 31 67 39 42 62 50 95 20 2 44 87 45 45 80 38 30 64 35 7 80 32 49 3 71 35 28 19 43 50 84
17 11 93 48 66 86 78 80 87 29 53 30 73 19 54 39 77 42 57 69 16 26 83 17 74 69 87 25 17 39 88 90 67 17 55 98 18 83 72 20 40 8 71 68 92 15 23 40 18 93 3 97 40 52 52 38 56 95 81 94 35 19 99 24 13 16 23 3 97 78 78 34 77 72 78 29 76 29 29 87 3 45 10 88 99 61 17 64 77 60 91 83 47 23 49 62 60 17 20 24
28 4 52 97 1 34 52 28 95 85 25 96 26 8 22 56 78 62 88 41 58 31 54 51 99 5 77 94 48 92 40 50 78 95 73 76 68 67 82 90 100 4 66 13 57 58 5 31 66 68 50 94 5 71 49 66 97 80 6 24 37 56 50 38 99 36 59 21 54 37 78 6 88 66 18 59 82 57 11 92 64 14 23 99 74 89 69 17 50 52 41 57 3 22 58 75 91 25 58 11
32 41 88 83 91 20 91 93 15 11 14 90 57 81 46 10 67 90 49 93 65 78 20 48 70 48 5 98 21 42 72 84 19 20 18 22 98 91 6 53 39 39 93 98 57 36 80 23 15 16 25 0 79 97 32 1 58 63 63 69 0 77 63 30 27 75 84 60 58 52 56 10 76 76 0 31 70 35 79 80 71 26 6 23 18 7 83 44 4 18 4 85 73 77 38 42 11 6 13 53
22 20 86 36 78 84 88 89 76 73 100 71 22 58 95 74 46 4 11 98 38 41 47 48 8 97 54 70 8 37 60 17 15 88 35 42 67 52 67 26 89 26 78 7 13 73 93 80 67 11 61 92 88 77 100 90 36 54 77 40 33 67 73 79 45 16 78 72 63 66 93 80 63 63 23 78 29 90 37 24 0 15 3 59 80 15 94 26 78 53 52 5 42 44 71 81 27 1 81 25
88 36 32 8 39 38 64 70 41 98 0 14 87 42 43 50 92 72 78 3 22 24 42 43 86 61 60 4 82 17 61 19 80 58 68 42 59 100 52 95 7 66 38 72 92 86 40 71 68 2 26 73 87 42 45 8 19 35 3 43 48 80 68 21 73 77 49 23 76 14 100 96 39 90 40 90 4 34 52 11 63 30 47 57 38 27 67 38 22 14 47 100 4 99 25 11 56 64 3 61
64 19 24 43 61 93 67 39 99 41 18 98 12 66 86 16 26 92 4 58 49 91 66 14 0 39 5 87 76 11 42 59 5 13 66 98 84 95 39 2 73 97 39 81 26 41 25 24 36 35 68 40 98 56 85 15 34 19 20 35 14 1 79 71 65 13 26 69 44 70 40 34 18 90 36 73 31 21 9 39 78 43 69 56 6 16 3 60 86 6 13 49 6 11 54 50 22 90 76 75
80 88 89 57 78 45 39 42 25 91 97 85 68 10 96 97 59 72 16 11 89 59 12 58 39 87 82 90 98 59 60 29 28 18 78 33 46 50 23 89 85 42 100 41 58 62 3 8 60 14 44 61 59 21 36 98 44 77 73 16 65 13 51 91 13 41 71 83 9 38 68 59 51 75 52 30 79 31 70 20 61 49 8 43 26 88 75 55 100 55 72 100 43 69 88 30 22 84 85 9
94 91 73 62 14 75 76 59 41 71 12 56 22 39 51 8 76 13 87 76 98 48 41 63 82 84 7 11 27 17 74 96 81 0 96 18 84 19 57 68 37 49 78 73 57 25 26 87 40 38 72 86 38 55 91 44 11 74 1 78 65 51 16 37 7 47 70 6 0 90 71 45 14 36 3 30 55 89 75 50 80 40 91 48 51 48 55 69 27 84 22 60 17 24 71 49 46 53 19 36
85 16 17 1 9 82 2 18 92 62 84 55 17 10 17 82 53 58 100 89 77 54 79 23 58 65 54 70 57 49 45 28 23 54 77 0 73 63 93 30 91 64 34 52 69 73 46 4 4 72 61 90 47 14 74 61 88 10 18 93 93 67 96 99 35 59 66 10 66 78 11 31 60 80 94 84 85 9 87 81 69 74 39 78 6 43 68 99 1 60 58 65 60 73 93 42 53 45 37 37
21 4 88 76 95 38 93 100 72 33 7 80 60 74 21 73 6 84 37 94 79 3 36 62 10 16 64 9 100 35 32 16 78 35 35 32 1 94 14 77 22 75 94 19 84 57 47 22 33 100 89 30 62 23 67 4 43 10 18 76 19 63 96 52 98 49 30 84 56 92 81 21 26 73 93 44 6 82 33 96 14 6 21 59 51 60 38 60 95 96 68 29 48 87 90 49 60 33 18 67
55 1 36 57 48 86 40 67 87 5 12 68 81 45 55 78 83 34 42 34 34 12 32 83 74 50 59 98 86 95 30 93 86 75 98 24 66 43 86 88 23 40 70 1 86 1 8 1 52 12 67 13 87 57 44 28 92 36 32 24 4 3 79 11 7 76 84 27 76 81 15 90 15 11 77 16 48 84 97 82 72 23 14 89 23 32 37 59 84 9 81 58 35 98 54 88 85 98 98 41
32 20 99 9 35 99 7 48 49 42 7 33 33 22 56 8 62 25 78 50 22 82 62 13 18 69 98 55 27 78 82 13 56 91 33 13 4 9 9 73 93 32 99 57 2 63 19 83 81 0 4 85 49 34 19 89 42 50 73 0 65 90 98 62 61 55 51 93 99 100 8 69 28 0 49 88 99 61 15 72 68 45 42 87 38 51 7 80 82 11 46 68 43 10 58 97 98 37 82 25
22 70 5 49 84 24 38 89 49 13 80 88 45 62 10 80 56 94 24 17 4 24 3 92 75 30 62 49 8 69 82 39 63 68 57 2 4 43 7 43 100 92 5 51 15 27 83 85 66 58 86 68 19 94 74 29 9 4 94 18 62 83 2 60 79 5 31 89 83 16 1 22 80 6 39 12 58 78 21 75 8 13 14 63 76 78 28 8 25 54 43 94 86 51 41 15 87 73 69 17
41 27 97 5 75 22 42 8 15 35 18 96 53 21 89 47 70 21 56 31 74 5 17 12 80 78 48 99 20 2 62 10 0 0 22 11 90 83 75 36 53 88 98 60 88 16 26 18 81 34 66 57 52 30 22 78 88 4 76 23 91 63 78 11 80 100 38 44 53 0 71 30 24 15 67 12 79 46 97 69 64 28 59 98 80 84 26 35 6 24 14 19 87 60 63 22 20 85 5 6
82 46 36 26 55 32 42 78 97 58 5 13 94 6 68 22 20 100 3 62 65 14 9 30 92 56 75 74 41 53 25 95 86 41 29 99 14 41 29 12 30 94 52 25 48 28 9 60 74 62 6 55 18 27 78 58 22 49 47 17 58 92 24 80 45 34 25 42 16 4 88 72 7 35 17 14 59 58 53 21 97 43 28 37 77 20 81 78 21 73 70 29 11 52 66 62 27 75 60 59
35 1 93 54 94 31 31 41 55 74 28 75 19 73 0 53 5 5 60 93 98 64 4 54 67 50 61 89 12 57 63 30 10 71 96 1 88 93 52 27 16 45 37 30 82 11 2 61 85 39 20 90 58 73 95 74 3 58 59 98 17 90 51 23 47 80 59 90 81 0 80 9 49 88 42 67 4 37 54 96 34 89 78 69 73 26 100 87 10 79 42 94 7 65 86 46 6 14 49 46
59 79 5 46 46 22 82 71 90 8 71 90 99 26 17 42 30 69 14 83 61 94 96 74 89 26 96 95 97 28 41 45 34 64 87 54 35 6 8 47 44 57 62 64 67 15 60 90 68 86 68 37 57 79 47 86 88 8 24 58 11 10 50 22 36 9 13 21 35 14 89 18 63 19 26 66 80 2 37 53 87 69 16 60 44 53 56 94 82 2 37 24 8 2 29 66 82 42 52 74
43 83 82 100 41 62 75 85 89 67 70 56 58 38 72 16 39 21 33 29 61 47 36 98 6 18 45 36 58 21 79 20 91 68 36 23 22 90 88 85 19 20 30 14 5 40 73 16 56 33 47 23 26 71 90 4 85 40 44 18 47 57 69 20 68 38 15 3 51 63 98 18 58 40 19 0 94 69 64 42 82 90 37 60 37 96 73 85 18 72 93 56 43 88 14 93 61 5 17 86
70 14 39 3 51 79 28 57 45 11 41 7 77 82 24 74 67 28 100 98 35 25 2 10 68 57 86 85 11 65 50 24 62 40 77 77 65 7 85 46 50 18 91 54 47 49 47 1 36 44 44 39 57 71 11 27 93 56 94 53 56 36 20 93 54 93 53 17 75 76 11 18 26 38 60 67 42 8 75 96 48 11 0 52 81 34 53 22 71 59 90 72 96 17 25 23 48 37 70 62
5 38 74 38 63 71 94 59 28 3 0 19 33 38 81 81 60 15 83 85 36 53 22 62 88 82 31 3 15 97 35 63 8 76 95 46 74 61 72 55 33 80 87 60 88 15 47 65 93 73 2 33 20 74 7 18 40 59 88 17 45 20 6 34 46 53 81 45 6 37 37 67 81 9 65 24 98 80 23 97 12 76 96 21 69 41 40 87 38 34 87 89 88 46 12 68 74 45 18 1
17 66 36 47 99 62 52 43 20 13 27 19 64 28 24 71 78 88 67 68 91 70 89 96 14 53 58 9 14 16 2 61 44 39 88 46 17 56 76 66 97 43 22 90 38 3 95 15 28 16 88 18 88 29 39 16 26 16 10 54 88 97 100 14 9 2 99 61 96 55 5 25 13 4 84 65 75 7 60 15 32 5 8 38 85 1 96 12 100 15 77 26 75 25 23 85 44 3 11 18
95 35 74 44 45 20 64 99 93 78 30 64 72 8 12 74 97 1 67 27 91 24 36 21 96 68 0 92 12 27 64 90 60 46 89 75 23 56 86 13 23 45 48 54 27 65 29 52 14 97 40 15 59 14 66 17 63 97 46 90 36 71 92 5 10 41 63 14 49 36 58 76 94 39 87 56 28 70 52 37 54 24 8 60 86 47 22 1 86 62 86 13 50 56 66 84 86 10 15 18
50 51 88 75 13 94 21 8 46 25 43 25 76 51 15 29 54 92 63 35 97 91 98 74 75 34 96 82 51 45 60 85 77 51 62 65 35 18 98 58 13 15 32 62 63 29 80 17 3 12 94 6 8 63 86 3 22 48 77 86 41 19 38 79 79 12 97 9 84 96 66 98 63 59 25 37 84 63 62 64 33 69 43 69 69 2 97 4 55 15 49 57 40 48 56 58 4 4 22 71
84 99 38 90 21 62 55 17 39 91 49 62 97 14 72 86 62 84 70 87 69 73 60 60 71 20 64 7 50 33 63 75 48 78 86 45 98 36 41 7 3 75 5 16 46 44 94 74 3 97 80 43 48 12 54 44 45 52 44 7 84 31 31 30 82 39 75 10 88 8 39 14 43 21 2 68 41 4 58 84 54 72 65 53 34 2 89 60 75 2 40 48 73 49 41 73 12 62 12 88
